                                                                         !                 $                 
                                                                         !                 $                 
                                                                         ===============  == 
                                                                        #               \/  #
                                                                        #                   #
                                                                        #                   #
                                                                         #                 # 
                                                                          #################  
